#############
#     # #   #
# ##### # # #
# ## ##   # #
# ## #### # #
# ## #  # # #
# ## # ## # #
# ## # ## # #
#         # #
#############