#############
#       #   #
# ### # # # #
# # # #   # #
# # ## #### #
# # #  #### #
#         # #
#############