############
#   #  # # #
###  # ##  #
#  # # ## ##
##         #
#          #
############