#################################################################
#                                                               #
#  ######   ##        #######  ########  ##    ##               #
# ##    ##  ##       ##     ## ##     ##  ##  ##                #
# ##        ##       ##     ## ##     ##   ####                 #
# ##   #### ##       ##     ## ########     ##                  #
# ##    ##  ##       ##     ## ##   ##      ##                  #
# ##    ##  ##       ##     ## ##    ##     ##                  #
#  ######   ########  #######  ##     ##    ##                  #
#                                                               #
# ########  #######                                             #
#    ##    ##     ##                                            #
#    ##    ##     ##                                            #
#    ##    ##     ##                                            #
#    ##    ##     ##                                            #
#    ##    ##     ##                                            #
#    ##     #######                                             #
#                                                               #
# ##     ## ##    ## ########     ###    #### ##    ## ######## #
# ##     ## ##   ##  ##     ##   ## ##    ##  ###   ## ##       #
# ##     ## ##  ##   ##     ##  ##   ##   ##  ####  ## ##       #
# ##     ## #####    ########  ##     ##  ##  ## ## ## ######   #
# ##     ## ##  ##   ##   ##   #########  ##  ##  #### ##       #
# ##     ## ##   ##  ##    ##  ##     ##  ##  ##   ### ##       #
#  #######  ##    ## ##     ## ##     ## #### ##    ## ######## #
#                                                               #
#################################################################