######
#  # #
#  # #
###  #
#    #
######