################
#              #
# ####### ######
# #            #
# # ########## #
# # #      #   #
# # # #### # ###
# # # #A # #   #
# # # ## # ### #
# # #    # #   #
# # ###### # ###
#          #   #
## ########### #
#              #
# ###   ##### B#
################